  +-+-+-+-+-+-+
|     |       |
+ +-+ + +-+-+ +
| |   |   | | |
+ + +-+-+ + + +
| |     |   | |
+ +-+-+ +-+ + +
| |   | |   | |
+ + + + + +-+ +
| | | | |   | |
+ +-+ + +-+ + +
| |   |   | | |
+ + + +-+-+-+ +
|   |         |
+-+-+-+-+-+-+-+